NO ./path_1
SO ./path_2
WE ./path_3
EA ./path_4

F 220,100,0
C 200,0,100

 1111111111
11000000001
10000000011
1000000001
1111111111
