NO ./texture/north.xpm
SO ./texture/south.xpm
WE ./texture/west.xpm
EA ./texture/east.xpm

F 220,100,0
C 200,0,100

11111111111
10000000001
110000000001
110000000001
111111111111