1111111111111111
1C000000000000E1
1000000000000001
100000P000000001
1000000000000001
1C00000000000001
1111111111111111