111111111111111
100001C0E0110C1
101001001010011
101001001010001
1P1C00001000C01
111111111111111
