111111111111111
100001C000110E1
101001001010011
101001001010001
1P1C01001000C01
111111111111111