11111111111111
1000001C00010E1
10100100101001
10100100101001
1P1C00001000C1
11111111111111