11111111111111
1E0001000010E1
10100100101001
10100100101001
1P1000001C00C1
11111111111111