11111111111111
100001000010E1
10100100101001
10100100101001
1P100000100001
11111111111111