11111111111111
100001C10010E1
10100010001001
10100100001001
1P1C00001000C1
11111111111111