11111111111111
100001C00011E1
10100100101011
10100100101001
1P1C00001000C1
11111111111111