11111111111111
100001C00010E1
10100100101001
10100100101001
1P1C00001000C0
11111111111111