11111111111111
1C000100001001
10100100101001
10100100101001
1P1000001000C1
11111111111111