11111111111111
100001C00010E1
10100100101001
11000100101001
1P1C00001000C1
11111111111111