NO ./texture/north.xpm
SO ./texture/south.xpm
WE ./texture/west.xpm
EA ./texture/east.xpm

F 220,100,0
C 200,0,100

111111111111
110000000011
10000000011
10000000011
11111011111