NO ./texture/north.xpm
SO ./texture/south.xpm
WE ./texture/west.xpm
EA ./texture/east.xpm

F 122,122,0
C 0,122,122

1111111111100E0011111111111